....1....
.........
.........
4.......5
.........
0⃘.3⃗.....2
.........
.........
....6....