....1....
.........
.........
..5...4..
.........
.........
0⃗...3⃖...2