....1....
.........
3.......4
.........
.........
.0⃕....2..
